0 0 0 0 0 0 0 0 0 0 0 0 3 5 5 5 5 5 5 5 5 2 0
4 4 4 0 0 0 0 4 0 0 0 0 3 5 5 5 5 5 5 5 5 2 0
5 5 5 2 0 0 3 5 2 0 0 0 3 5 5 5 5 5 5 5 5 2 0
5 5 5 2 0 0 3 5 2 0 0 0 0 1 1 1 1 1 1 1 1 0 0
5 5 5 6 4 0 0 1 0 0 0 0 0 0 0 0 0 0 0 0 0 0 0
5 5 5 5 5 6 0 0 0 0 0 0 0 0 0 0 0 0 0 0 0 0 0
5 5 5 5 5 5 6 4 0 0 0 0 4 4 0 0 0 0 4 4 4 4 4
5 5 5 5 5 5 5 5 2 0 0 3 5 5 2 0 0 3 5 5 5 5 5
5 5 5 5 5 5 5 5 2 0 0 0 1 1 0 0 0 3 5 5 5 5 5
5 5 5 5 5 5 5 5 2 0 0 0 0 0 0 0 0 3 5 5 5 5 5
5 5 5 5 5 5 5 7 0 0 0 0 0 0 0 0 0 0 1 1 1 1 1 
5 5 5 5 5 7 1 0 0 0 0 0 0 0 0 0 4 0 0 0 0 0 0
5 5 5 7 1 0 0 0 0 0 0 0 0 0 0 3 5 2 0 0 0 0 0
5 5 7 0 0 0 0 0 4 4 4 4 4 4 0 0 1 0 0 0 0 0 0 
5 7 0 0 4 0 0 3 5 5 5 5 5 5 6 0 0 0 0 0 4 4 4
1 0 0 3 5 2 0 3 5 5 5 5 5 5 5 6 0 0 0 3 5 5 5
0 0 0 0 1 0 0 3 5 5 5 5 5 5 5 5 2 0 0 3 5 5 5